2
1111111111
1S00010011
1011010111
1001000101
1011011101
1001111101
1111111101
1000010001
1011111101
1111111111