3
1111111111
1S00010001
1011010101
1001000101
1011011101
1000000001
1111111111
1000000001
1011111101
1G11111111